   #    #
   #    #
   #    #
#          #
 ##      ##
   ######