####################
#                  #
#                  #
#                  #
#                  #
#        P         #
#                  #
#                  #
#                  #
#                  #
####################