   #    #
   #    #
   #    #
#      P    #
 ##      ##
   ######