####################
#                  #
#                  #
#                  #
#                  #
#                  #
# x      P       x #
#                  #
#      #####       #
###    x   x     ###
###              ###
####################
20
10
11
05