####################
#                  #
#                  #
#                  #
#                  #
#                  #
#        P         #
#      #####       #
#^^                #
###                #
###              ^^#
####################
20
11