####################
#                  #
#                  #
#                  #
#                  #
#                  #
#        P         #
#                  #
#      #####       #
###              ###
###              ###
####################
20
10
11
05