####################
####################
########
##
#
#                ###
              ######
P  ##         ######
#####  ##  ^^^######
#####  ##^^#########
#####^^#############
####################
19
02
00
07