GGGGGFBBBBBBBbbBBbdg
GGFBBV            cd
KFV    u           l
FV                 l
V        MOOM      l
    ZX             l
   ZAR        zx   l
P  LGR        lr  ul
TTTAFV     ^^-lr   l
GGGGR    ^^ZTtar   l
GGGGR^--^ZTAGugr   l
GKGGSTttTAGGgggr   l
15
10
19
12