GGGGGGGGGGGGGGGGGGGG
GGGGKGGFBBBBBBBBBBBB
KFBBBBBV
FV                u
R
V                ZTT
              ZTTAGG
P  ZX   u     LGGGGG
TTTAR  MM  ^^^LGGKKG
GGGGR  II^^ZTTAGGKGG
GGGGR^^IIZTAGGGKGGGG
GKGGSTTIILGGKGGGGGGG
20
01
21
05