####################
#####             ##
###       ######  ##
##     ######   ^ ##
####     ####  #####
#######     #  ###
##        ###  ###
######      #
########     #######
           #########
P     ###^^     ####
####################
19
05
00
10