GGGGGGG9GGGGGGGGFBBB
BBBDGGG9GG803GGFV
   CBDG6005GGGFV
     CBDGGGGGFV
P      LGGGGFV     Z
TTX    CDGGFV     ZA
GGR     CDGR     ^LG
GGSX     CBV     ZAG
G27SX          ^ZAGG
GG9GSX         ZAGGG
GG9GGR^^^     ZAGGGG
GG4GGSTTTTTTTTAGGGGG
19
01
00
04