####################
####$##FBBBBBBBBBBBB
$FBBBBBV
FV
R
V                ZTT
              ZTTA##
P  ZX         L#####
TTTAR  **  ^^^L##$$#
####R  ||^^ZTTA##$##
####R^^||ZTA###$####
#$##STT||L##$#######
19
02