GGGGGFBBBBBBBBBBBBDG
GGFBBV            CB
KFV                L
FV                 L
V        MOOM      l
    ZX             l
   ZAR        zx   l
P  LGR        lr   l
TTTAFV     ^^-lr   l
GGGGR    ^^ZTtar   l
GGGGR^^^^ZTAGggr   l
GKGGSTTTTAGGKggr   l
15
10
00
07