####################
####          ######
#      *         ###
      ####   *    ##
P               ^^##
###^^      ^^  ^####
#####^    ^##  ^####
######^^^^###  ^####
##  #########     ##
#        #####   *
##    ########
####################
19
09
00
04