####################
####################
########
##
#
#                ###
              ######
 P ##         ######
#####  ##  ^^^######
#####  ##^^#########
#####^^#############
####################
