GGGGGFBBBBBBBbbBBbdg
GGFBBV            cd
KFV                l
FV                 l
V        MOOM      l
    ZX             l
   ZAR        zx   l
P  LGR        lr   l
TTTAFV     ^^-lr   l
GGGGR    ^^ZTtar   l
GGGGR^--^ZTAGugr   l
GKGGSTttTAGGgggr   l
15
10
00
07