GGGGGGGGGGGGGGGGGGGG
GGGGGGGGGGGGGGGGG
   GGGGGGGGGGGGG
     GGGGGGGGGG
P      GGGGGGG     G
GGG    GGGGGG     GG
GGG     GGGG      GG
GGGG     GGG     GGG
GGGGG     G     GGGG
GGGGGG         GGGGG
GGGGGG        GGGGGG
GGGGGGGGGGGGGGGGGGGG
19
09
00
04