GGGGGGGGGGGGGGGGGGGG
GGGGKGGFBBBBBBBBBBBB
KFBBBBBV
FV
R
V                ZTT
              ZTTAGG
P  ZX         LGGGGG
TTTAR  MM  ^^^LGGKKG
GGGGR  II^^ZTTAGGKGG
GGGGR^^IIZTAGGGKGGGG
GKGGSTTIILGGKGGGGGGG
19
02