####################
####          ######
#      x         ###
      ####   x    ##
P               ^^##
###^^      ^^  ^####
#####^    ^##  ^####
######^^^^###  ^####
##  #########     ##
#        #####   x
##    ########
####################
19
09
00
04