BBBBBBBBBBBIGG6007GG
           IGGGGG9GG
P    ^     IBBBDG9GG
OOOOOM     M   LG63G
GFV      ^   ^ LGGGG
GR   MOOOOOOOOOMBBBB
GR
GSTTTX
GGGGGR            ZT
GGGGGR  MOM  MOM  LG
GGGGGR^^^^^^^^^^^^LG
GGGGGSTTTTTTTTTTTTAG
19
06
00
02