####################
####          ######
#                ###
      ####        ##
P               ^^##
###^^      ^^  ^####
#####^    ^##  ^####
######^^^^###  ^####
##  #########     ##
#        #####
##    ########
####################