GGGGGGKGGGGKGGGGGG9G
BBBBBBBBBBBBBDGGGK9G
             CBBDG9G
P               LG9K
OOOOOOOOOOM     LG63
TTX             LGGG
GKR    MOOOIOOOOLGKG
GGR        I    LGGG
GGR        M    CBBB
KGR    M
GGR    I
GGSTTTTITTTTTTTTTTTT
19
09
00
03