GGGGGGGFBBBBBBBBBBBB
GGGGGGFV*
GGGFBBV
FBBV       MOOOOOOOO
R                  Z
R   ^^            *L
R   MOOM         ZTA
R              ^^LGG
V      MOM   ZTTTAGG
    ^^      ^LGGGGGG
P   ZTTTTTTTTAGGGGGG
TTTTAGGGGGGGGGGGGGGG
20
00
21
03