BBBBBBBBBBBIGG6007GG
           IGGGGG9GG
P    ^     IBBBDG9GG
OOOOOM     M   LG63G
GFV      ^   ^ LGGGG
GR   MOOOOOOOOOMBBBB
GR
GSTTTX
GGGGGR            ZT
GGGGGR  MOM  MOM  LG
GGGGGR^^^^^^^^^^^^LG
GGGGGSTTTTTTTTTTTTAG
20
05
21
08